%%%%%%%
% P   %
% %%% %
% %.  %
% %%% %
%.    %
%%%%%%%
